{
  "palette": [
    "Red Box",
    "Green Box",
    "Blue Box"
  ],
  
  "tiles": [
    [ 0, 1, 2, 0, 1, 2 ],
    [ 1, 2, 0, 1, 2, 0 ],
    [ 2, 0, 1, 2, 0, 1 ],
    [ 0, 1, 2, 0, 1, 2 ],
    [ 1, 2, 0, 1, 2, 0 ],
    [ 2, 0, 1, 2, 0, 1 ],
    [ 0, 1, 2, 0, 1, 2 ],
    [ 1, 2, 0, 1, 2, 0 ],
    [ 2, 0, 1, 2, 0, 1 ],
    [ 0, 1, 2, 0, 1, 2 ],
    [ 1, 2, 0, 1, 2, 0 ],
    [ 2, 0, 1, 2, 0, 1 ]
  ]
}